#######################
##T.....T.............#
#TT..T................#
#...TTT...............#
#.T..T.TT.............#
#TT....TT.............#
#####.#####...........#
###########...#########
##T.....T.............#
#TT..T................#
#...TTT...............#
#.T..T.TT.............#
#TT....TT.............#
#####.#####...........#
###########...#########
##T.....T.............#
#TT..T................#
#...TTT...............#
#.T..T.TT.............#
#TT....TT.............#
#####.#####...........#
###########...#########
##T.....T.............#
#TT..T................#
#...TTT...............#
#.T..T.TT.............#
#TT....TT.............#
#####.#####...........#
###########...#########
##T.....T.............#
#TT..T................#
#...TTT...............#
#.T..T.TT.............#
#TT....TT.............#
#######################
TEXTURES:
textures/redbrks.xpm
textures/redbricks.xpm
textures/redbricks.xpm
textures/redbricks.xpm