###########
##T.....T.#
#TT..T....#
#...TTT...#
#.T..T.TT.#
#TT....TT.#
###########
TEXTURES:
textures/wood.xpm
textures/wood.xpm
textures/b2o.xpm
textures/b2o.xpm