###########
#.........#
#.........#
#.........#
#.........#
#...#T#...#
#.........#
#.........#
#.........#
###########
TEXTURES:
textures/redbricks.xpm
textures/pillar.xpm
textures/redbricks.xpm
textures/redbricks.xpm
