#####.................T.
#..........#...######..T
#.......#....#......#...
#.....#########T..###...
#T....#....#........#..T
#T.....#...............T
#..........#....T.......
#...#..TTT....#........#
#..###...###....#...#...
#...#....#.....#.#..#...
#........#......#...#...
##################......
TEXTURES:
textures/redbricks.xpm
textures/jose.xpm
textures/cricri.xpm
textures/helene.xpm