#####
#..........#...######
#.......#....#......#
#.....#########...###
#.....#....#........#
#......#............
#..........#
#...#.........#........#
#..###...###....#...#
#...#....#.....#.#..#
#........#......#...#
##################
TEXTURES:
textures/stones.xpm
textures/redbricks.xpm
textures/wood.xpm
textures/boul.xpm